11111111111
11C00E00111
1100P011011
10000000001
1010C000101
10000001001
10000000001
10111111101
10000000001
1000C011101
1000C00C001
11111111111
