111111111111111111111111
1EC010000000000000000001
1110000000000000000000P1
101111111111111111111111
100000000000000000000001
111111111111111111111101
100000000000000000000001
111111111111111111111111
100000000000000000000001
111111111111111111111101
100000000000000000000001
101111111111111111111111
100000000000000000000001
111111111111111111111111