11111
1PCC1
11111
111E1
111111